A	HHAHHAOOAOO
B	HHBHHBOOBOO
E	HHEHHEOOEOO
F	HHFHHFOOFOO
G	HHGHHGOOGOO
H	HHHHHHOOHOO
I	HHIHHIOOIOO
M	HHMHHMOOMOO
N	HHNHHNOONOO
O	HHOHHOOOOOO
R	HHRHHROOROO
S	HHSHHSOOSOO
T	HHTHHTOOTOO
U	HHUHHUOOUOO
a	nnannaooaoo
b	nnbnnbooboo
e	nnenneooeoo
f	nnfnnfoofoo
g	nngnngoogoo
h	nnhnnhoohoo
l	nnlnnlooloo
m	nnmnnmoomoo
n	nnnnnnoonoo
o	nnonnoooooo
r	nnrnnrooroo
s	nnsnnsoosoo
t	nntnntootoo
u	nnunnuoouoo
v	nnvnnvoovoo
覺	nn覺nn覺oo覺oo
